Folder,#Files,#LoC,Theorems,Implementations,Documentation,#Doc/#LoC (%),Proved
beacon,19,3814,94,151,2910,76,245
beacon/attestations,1,30,0,0,68,227,0
beacon/forkchoice,2,238,3,15,189,79,18
beacon/helpers,3,13,0,1,530,4077,1
beacon/helpers/helper_lemmas,1,3,0,0,413,13767,0
beacon/statetransition,7,2141,57,40,1019,48,97
beacon/validators,1,11,0,0,53,482,0
merkle,1,504,9,18,135,27,27
ssz,7,1277,23,21,256,20,44
utils,8,981,44,18,437,45,62
